XXXXXXXXXXXXXXXXXXXXXXXXX
XP                      X
X X XXX XXXXX XXXXX XXX X
X X  T  X  X  X  X  X   X
X X XXX XXXXX XXXXX XXX X
X X  X  X  X  X  G   X   X
X X XXX XXXXX XXXXX XXX X
X X  X  XT X  X  X  X   X
X X XXX XXXXX XXXXX XXX X
X X  X  X  X  XT X  X   X
X X XXX XXXXX XXXXX XXX X
X X  X  X  XG X  X  X   X
X X XXX XXXXX XXXXT XXX X
X X  X  X  X  X  X  X   X
X X XXX XXXXX XXXXX XXX X
X X  X  X  X  X  X  X   X
X X XXX XXXXX XXXXX XXX X
X X  X  G  X  X  X  X   X
X X XXX XXXXX XXXXX XXX X
X X  XT X  X  X  X  X   X
X X XXX XXXXX XXXXX XXX X
X X  X  X  X  X  X  X   X
X X XXX XXXXX XXXXX XXX X
X                     E X
XXXXXXXXXXXXXXXXXXXXXXXXX